jurisdiction	circ
10TH CIRCUIT - COURT OF APPEALS	10th
10TH CIRCUIT - U.S. DISTRICT COURTS	10th
COLORADO COURT OF APPEALS	10th
COLORADO SUPREME COURT	10th
KANSAS COURT OF APPEALS	10th
KANSAS SUPREME COURT	10th
NEW MEXICO COURT OF APPEALS	10th
NEW MEXICO SUPREME COURT	10th
OKLAHOMA COURT OF APPEALS	10th
OKLAHOMA COURT OF CRIMINAL APPEALS	10th
OKLAHOMA SUPREME COURT	10th
OTHER UTAH DECISIONS	10th
UTAH COURT OF APPEALS	10th
UTAH SUPREME COURT	10th
WYOMING SUPREME COURT	10th
11TH CIRCUIT - COURT OF APPEALS	11th
11TH CIRCUIT - U.S. BANKRUPTCY COURTS	11th
11TH CIRCUIT - U.S. DISTRICT COURTS	11th
ALABAMA COURT OF APPEALS	11th
ALABAMA COURT OF CIVIL APPEALS	11th
ALABAMA COURT OF CRIMINAL APPEALS	11th
ALABAMA SUPREME COURT	11th
FLORIDA	11th
FLORIDA DISTRICT COURT OF APPEALS	11th
FLORIDA SUPREME COURT	11th
GEORGIA	11th
GEORGIA COURT OF APPEALS	11th
GEORGIA SUPREME COURT	11th
1ST CIRCUIT - COURT OF APPEALS	1st
1ST CIRCUIT - U.S. DISTRICT COURTS	1st
MAINE SUPREME JUDICIAL COURT	1st
MASSACHUSETTS APPEALS COURT	1st
MASSACHUSETTS SUPREME JUDICIAL COURT	1st
NEW HAMPSHIRE SUPREME COURT	1st
OTHER MAINE DECISIONS	1st
OTHER MASSACHUSETTS DECISIONS	1st
OTHER RHODE ISLAND DECISIONS	1st
PUERTO RICO	1st
PUERTO RICO COURT OF APPEALS	1st
PUERTO RICO SUPREME COURT	1st
RHODE ISLAND SUPREME COURT	1st
2ND CIRCUIT - COURT OF APPEALS	2nd
2ND CIRCUIT - U.S. DISTRICT COURTS	2nd
CONNECTICUT APPELLATE COURT	2nd
CONNECTICUT SUPREME COURT	2nd
NEW YORK COURT OF APPEALS	2nd
NEW YORK SUPREME COURT APP. DIV.	2nd
OTHER CONNECTICUT DECISIONS	2nd
OTHER NEW YORK DECISIONS	2nd
OTHER VERMONT DECISIONS	2nd
VERMONT SUPREME COURT	2nd
3RD CIRCUIT - COURT OF APPEALS	3rd
3RD CIRCUIT - U.S. DISTRICT COURTS	3rd
DELAWARE COURT OF CHANCERY	3rd
DELAWARE SUPREME COURT	3rd
NEW JERSEY SUPERIOR COURT	3rd
NEW JERSEY SUPREME COURT	3rd
OTHER DELAWARE DECISIONS	3rd
OTHER NEW JERSEY DECISIONS	3rd
OTHER PENNSYLVANIA DECISIONS	3rd
OTHER VIRGIN ISLANDS DECISIONS	3rd
PENNSYLVANIA COMMONWEALTH COURT	3rd
PENNSYLVANIA SUPERIOR COURT	3rd
PENNSYLVANIA SUPREME COURT	3rd
VIRGIN ISLANDS SUPREME COURT	3rd
4TH CIRCUIT - COURT OF APPEALS	4th
4TH CIRCUIT - U.S. DISTRICT COURTS	4th
MARYLAND COURT OF APPEALS	4th
MARYLAND COURT OF SPECIAL APPEALS	4th
NORTH CAROLINA COURT OF APPEALS	4th
NORTH CAROLINA SUPREME COURT	4th
OTHER VIRGINIA DECISIONS	4th
SOUTH CAROLINA COURT OF APPEALS	4th
SOUTH CAROLINA SUPREME COURT	4th
VIRGINIA COURT OF APPEALS	4th
VIRGINIA SUPREME COURT	4th
WEST VIRGINIA SUPREME CT. OF APPEALS	4th
5TH CIRCUIT - COURT OF APPEALS	5th
5TH CIRCUIT - U.S. DISTRICT COURTS	5th
LOUISIANA COURT OF APPEALS	5th
LOUISIANA SUPREME COURT	5th
MISSISSIPPI COURT OF APPEALS	5th
MISSISSIPPI SUPREME COURT	5th
TEXAS	5th
TEXAS COURT OF APPEALS	5th
TEXAS COURT OF CIVIL APPEALS	5th
TEXAS COURT OF CRIMINAL APPEALS	5th
TEXAS SUPREME COURT	5th
6TH CIRCUIT - COURT OF APPEALS	6th
6TH CIRCUIT - U.S. DISTRICT COURTS	6th
KENTUCKY COURT OF APPEALS	6th
KENTUCKY SUPREME COURT	6th
MICHIGAN COURT OF APPEALS	6th
MICHIGAN SUPREME COURT	6th
OHIO	6th
OHIO COURT OF APPEALS	6th
OHIO SUPREME COURT	6th
OTHER OHIO DECISIONS	6th
TENNESSEE COURT OF APPEALS	6th
TENNESSEE COURT OF CRIMINAL APPEALS	6th
TENNESSEE SUPREME COURT	6th
7TH CIRCUIT - COURT OF APPEALS	7th
7TH CIRCUIT - U.S. DISTRICT COURTS	7th
ILLINOIS APPELLATE COURT	7th
ILLINOIS SUPREME COURT	7th
INDIANA COURT OF APPEALS	7th
INDIANA SUPREME COURT	7th
WISCONSIN COURT OF APPEALS	7th
WISCONSIN SUPREME COURT	7th
8TH CIRCUIT - COURT OF APPEALS	8th
8TH CIRCUIT - U.S. BANKRUPTCY COURTS	8th
8TH CIRCUIT - U.S. DISTRICT COURTS	8th
ARKANSAS COURT OF APPEALS	8th
ARKANSAS SUPREME COURT	8th
IOWA COURT OF APPEALS	8th
IOWA SUPREME COURT	8th
MINNESOTA COURT OF APPEALS	8th
MINNESOTA SUPREME COURT	8th
MISSOURI COURT OF APPEALS	8th
MISSOURI SUPREME COURT	8th
NEBRASKA COURT OF APPEALS	8th
NEBRASKA SUPREME COURT	8th
NORTH DAKOTA SUPREME COURT	8th
SOUTH DAKOTA SUPREME COURT	8th
9TH CIRCUIT - COURT OF APPEALS	9th
9TH CIRCUIT - U.S. DISTRICT COURTS	9th
ALASKA COURT OF APPEALS	9th
ALASKA SUPREME COURT	9th
ARIZONA COURT OF APPEALS	9th
ARIZONA SUPREME COURT	9th
CALIFORNIA	9th
CALIFORNIA COURTS OF APPEAL	9th
CALIFORNIA SUPREME COURT	9th
GUAM SUPREME COURT	9th
HAWAI'I INTERMEDIATE COURT OF APPEALS	9th
HAWAI'I SUPREME COURT	9th
IDAHO COURT OF APPEALS	9th
IDAHO SUPREME COURT	9th
MONTANA SUPREME COURT	9th
NEVADA SUPREME COURT	9th
OTHER NEVADA DECISIONS	9th
NORTHERN MARIANA ISLANDS SUPREME COURT	9th
OREGON COURT OF APPEALS	9th
OREGON SUPREME COURT	9th
OTHER ARIZONA DECISIONS	9th
OTHER MONTANA DECISIONS	9th
UNPUBLISHED CALIFORNIA APPELLATE DECISIONS	9th
WASHINGTON COURT OF APPEALS	9th
WASHINGTON SUPREME COURT	9th
D.C. CIRCUIT - COURT OF APPEALS	DC
D.C. CIRCUIT - U.S. DISTRICT COURT	DC
D.C. COURT OF APPEALS	DC
ADMINISTRATIVE AGENCY DECISIONS	NAT
COMPTROLLER GENERAL	NAT
CT. OF APP. FOR THE ARMED FORCES	NAT
CT. OF CRIMINAL APPEALS	NAT
FEDERAL CIRCUIT - COURT OF APPEALS	NAT
FEDERAL CLAIMS COURT	NAT
IRS AGENCY MATERIALS	NAT
NATIONAL LABOR RELATIONS BOARD	NAT
OTHER FEDERAL DECISIONS	NAT
REGIONAL RAIL REORG. COURT	NAT
TEMPORARY EMERGENCY COURT OF APPEALS	NAT
U.S. CIRCUIT COURT OF APPEALS	NAT
U.S. SUPREME COURT	NAT
U.S. TAX COURT	NAT
